business.person.company	per:company
people.person.religion	per:religion
people.person.nationality	per:nationality
people.place_lived.person	per:place_lived
people.person.place_lived	per:place_lived
people.place_lived	per:place_lived
people.person.children	per:children
people.person.place_of_birth	per:place_of_birth
people.deceased_person.place_of_death	per:place_of_death
organization.organization.founders	per:founders
business.company.founders	per:founders
people.person.education	per:education
education.education.degree	per:degree
people.person.ethnicity	per:ethnicity
people.ethnicity.people	per:ethnicity
education.education.institution	per:institution
education.education.student	per:student
education.educational_degree.people_with_this_degree	per:degree
/people/person/education./education/education/degree	per:degree
/people/person/education./education/education/institution	per:institution
/business/person/company	per:company
/people/person/religion	per:religion
/business/company/founders	per:founders
/people/person/nationality	per:nationality
/people/person/place_of_birth	per:place_of_birth
/people/person/place_lived	per:place_lived
/people/deceased_person/place_of_death	per:place_of_death
/people/person/children	per:children
/people/person/ethnicity	per:ethnicity
/people/ethnicity/people	per:ethnicity
per:countries_of_residence	per:place_lived
per:country_of_birth	per:place_of_birth
per:country_of_death	per:place_of_death
org:founded_by	per:founders
per:children	per:children
per:religion	per:religion
per:employee_or_member_of	per:company
None	None